0 0 0 0 0 0 0 0 0 0 0 0 0 0 0 0 0 0 0 0 0 0 0 0 0 0 42 0 0 0 0 0 0 0 0 0 0 0 0 0 0 0 0 0 0 0 0 0 0 0 
0 0 0 0 0 0 0 0 0 0 0 0 0 0 0 0 0 0 0 42 42 0 0 0 0 0 42 0 0 0 42 0 0 0 0 0 0 0 0 0 0 0 0 0 0 0 0 0 0 0 
0 0 0 0 42 0 0 0 0 0 0 0 0 0 0 0 0 0 0 0 0 0 0 0 0 0 0 0 0 0 0 0 42 0 0 42 0 0 0 0 0 0 0 0 0 0 0 0 0 0 
0 0 0 42 42 0 0 0 0 0 0 0 0 0 0 0 0 0 0 0 0 0 0 0 0 42 42 42 0 0 0 0 42 0 0 42 0 0 0 0 42 0 0 0 0 0 0 0 0 0 
0 0 0 0 0 0 0 42 42 0 0 0 0 42 42 42 42 0 0 0 0 0 0 42 42 0 0 0 0 0 0 0 0 0 0 0 0 0 0 0 42 42 42 42 0 0 42 0 0 0 
0 0 0 0 0 42 0 0 0 0 0 0 0 0 0 0 42 42 0 42 42 0 0 0 42 42 0 0 42 42 0 0 0 0 0 0 42 42 42 0 0 0 0 0 0 0 0 42 0 0 
0 0 0 0 42 42 0 0 0 0 42 0 42 42 0 0 0 0 0 0 0 42 0 0 0 0 42 42 42 42 0 0 42 42 0 0 0 0 0 0 0 0 0 0 0 0 0 42 0 0 
0 0 0 42 0 0 0 42 42 0 0 0 0 0 0 42 42 0 0 42 0 0 0 0 0 0 0 0 0 0 0 0 42 42 42 0 42 0 0 0 0 0 0 0 0 0 0 42 0 0 
0 42 0 42 0 0 0 0 0 0 0 0 0 0 0 0 0 0 0 0 0 0 0 0 0 0 0 0 0 0 0 0 0 0 0 42 0 42 42 42 0 0 42 42 42 42 42 0 0 0 
0 42 0 42 0 0 0 0 0 0 0 0 0 0 0 0 0 0 8 16 16 16 16 16 16 16 9 0 0 0 0 0 0 0 0 0 0 0 0 0 0 0 0 0 0 42 0 0 0 0 
0 0 0 0 0 0 42 42 0 0 0 0 8 16 16 16 16 16 15 1 38 60 1 28 27 27 14 16 16 16 16 16 16 16 16 9 0 0 0 0 0 0 42 42 42 0 0 0 0 0 
0 0 0 0 0 0 0 0 0 0 0 0 12 1 1 1 1 1 36 1 1 49 48 1 27 27 1 38 38 1 26 31 38 1 1 14 16 16 16 16 16 9 0 0 0 0 42 42 0 0 
0 0 42 0 0 0 0 0 0 8 16 16 15 1 27 1 1 36 37 37 1 46 47 33 27 27 49 20 20 20 20 20 20 48 39 1 39 1 39 27 27 13 0 0 42 42 42 0 42 0 
0 0 42 42 0 42 0 0 0 12 1 1 35 1 27 27 27 1 27 27 27 1 1 1 33 1 17 25 25 25 25 25 25 24 20 20 20 20 48 1 27 13 0 42 42 0 42 0 42 0 
0 0 42 42 42 0 0 0 0 12 29 26 26 1 1 27 27 27 27 27 27 27 27 27 27 30 17 25 25 25 25 25 25 25 25 25 25 25 18 1 27 13 0 42 0 0 0 0 0 0 
0 0 0 0 0 0 0 0 0 12 1 26 29 38 38 35 26 26 27 27 27 27 27 27 27 1 17 25 25 25 25 25 25 25 25 25 25 25 18 1 27 13 0 0 0 0 0 0 0 0 
0 0 0 0 0 0 0 0 0 12 35 1 1 36 1 1 1 1 1 1 1 32 32 32 1 1 17 25 25 25 25 25 25 25 25 25 25 25 18 27 27 13 0 0 42 42 42 0 0 0 
0 0 0 42 42 0 0 0 8 15 1 1 49 20 20 20 20 20 20 20 20 20 20 20 20 20 23 25 25 25 25 25 25 25 25 25 25 25 18 27 27 13 0 0 0 0 42 42 0 0 
0 0 0 42 0 0 0 0 12 1 36 36 17 25 22 19 19 19 19 19 19 19 19 19 19 19 19 19 19 19 19 19 19 19 19 19 19 19 47 1 27 13 0 0 42 0 0 0 0 0 
0 0 0 42 0 0 42 0 10 5 1 1 17 25 18 1 1 37 1 1 37 37 38 30 1 37 38 1 37 37 1 38 37 37 1 1 37 37 4 3 2 11 0 0 42 42 0 0 0 0 
0 0 0 0 0 42 42 0 0 12 1 1 17 25 18 1 37 37 1 38 1 37 1 30 37 37 1 1 37 37 38 1 37 37 38 37 37 27 13 0 0 0 0 0 0 0 0 0 0 0 
0 42 0 0 42 0 0 0 0 12 1 1 17 25 18 38 1 1 4 2 3 2 3 2 3 2 3 2 3 2 3 2 5 1 38 1 27 27 13 0 42 42 42 0 42 42 0 0 0 0 
0 42 42 0 42 0 0 0 0 12 36 1 17 25 18 1 37 30 7 0 0 0 0 0 0 0 0 0 0 42 0 0 6 33 1 1 1 27 13 0 0 0 0 0 0 42 0 0 0 0 
0 0 0 0 42 0 0 8 16 15 36 1 17 25 18 1 37 30 7 44 0 0 42 0 42 0 42 0 42 0 42 0 6 33 1 30 30 27 13 0 0 42 42 42 0 42 42 0 0 0 
0 0 0 0 42 0 0 12 27 27 1 1 17 25 18 38 1 1 7 0 42 0 43 0 0 0 45 0 45 0 42 0 6 33 38 30 26 27 13 0 0 42 42 42 42 0 0 42 0 0 
0 0 0 0 0 0 0 12 36 36 1 1 17 25 24 20 20 48 7 0 0 0 0 43 45 0 0 0 0 42 0 0 6 30 38 38 1 27 13 42 42 42 42 42 42 0 0 42 0 0 
0 0 0 0 0 0 0 12 27 27 1 1 17 25 22 19 19 47 7 43 0 0 45 0 0 0 44 42 0 0 0 8 15 34 1 1 27 27 13 42 42 42 42 42 0 0 0 0 0 0 
0 0 42 42 42 0 0 12 1 1 49 20 23 25 18 1 30 30 7 43 45 0 42 42 0 44 0 0 0 8 16 15 34 34 1 1 37 27 13 0 0 42 0 42 0 0 0 0 0 0 
0 0 0 0 0 0 0 10 5 1 46 19 21 25 18 30 38 38 7 43 0 0 0 0 0 0 0 0 8 15 34 34 34 34 1 1 37 27 13 0 0 42 0 42 42 0 0 0 0 0 
0 0 0 0 42 0 0 0 10 5 27 38 17 25 18 1 38 38 14 16 16 16 16 16 16 16 16 16 15 1 1 30 1 1 30 1 37 27 13 0 42 42 0 0 0 0 0 0 0 0 
0 0 0 0 0 42 0 0 0 12 27 38 17 25 18 1 38 38 33 33 1 33 36 36 37 36 37 30 1 30 1 1 49 20 20 48 27 27 13 0 0 0 42 42 42 0 0 0 0 0 
0 0 42 0 0 42 0 0 0 12 27 1 17 25 18 1 1 38 1 33 38 1 1 38 1 1 37 1 1 30 1 1 17 25 25 18 1 27 13 0 42 42 0 42 42 0 0 0 0 0 
0 0 42 0 0 42 0 0 0 12 27 49 23 25 24 20 20 20 20 20 20 20 20 20 20 20 20 20 20 20 20 20 23 25 25 18 27 27 13 0 0 42 0 0 42 0 0 0 0 0 
0 0 0 0 0 0 0 0 0 12 1 46 19 21 25 22 19 19 19 19 19 19 19 19 19 19 19 19 19 19 19 19 21 25 25 18 27 27 13 0 0 0 0 42 0 0 0 0 0 0 
0 0 0 0 0 0 0 0 0 12 28 28 38 17 25 18 1 38 38 33 38 33 33 33 38 32 38 38 38 32 38 38 46 19 19 47 39 1 13 0 42 42 0 42 42 42 0 0 0 0 
0 0 0 42 0 0 0 0 0 10 3 5 38 17 25 18 38 1 38 49 20 20 48 27 32 32 1 27 27 32 38 27 27 1 1 27 1 27 13 0 42 42 42 42 42 42 0 0 0 0 
42 42 0 0 0 0 0 42 0 0 0 12 38 17 25 24 20 20 20 22 19 21 18 27 27 27 1 27 27 1 27 27 27 27 27 1 1 4 11 0 0 0 42 0 0 42 0 0 0 0 
0 0 42 42 0 0 0 0 0 0 0 12 38 17 25 25 25 25 25 18 1 17 18 1 27 27 1 27 27 1 27 27 27 38 1 1 27 13 0 0 42 42 42 42 42 0 0 0 0 0 
0 0 0 42 0 0 0 0 0 0 0 12 28 17 25 25 25 25 25 18 37 17 18 26 1 26 26 33 33 1 27 27 38 38 1 1 27 13 0 0 0 0 0 42 42 0 0 0 0 0 
0 0 0 0 0 42 0 0 0 42 0 12 28 17 25 25 25 25 25 18 1 17 18 1 30 38 26 33 33 38 38 1 1 1 1 61 27 13 0 0 42 42 0 0 42 0 42 0 0 0 
0 0 0 0 0 42 42 0 42 42 0 12 29 46 19 19 19 19 19 24 20 23 18 27 1 38 38 1 38 1 38 27 38 30 30 1 33 13 0 0 0 0 42 42 42 0 0 0 0 0 
0 0 0 0 0 42 42 42 42 0 0 12 1 29 27 27 27 1 27 46 19 19 47 27 1 1 27 1 1 27 1 27 27 1 27 33 33 13 42 42 0 0 0 0 42 0 0 42 0 0 
0 0 42 42 42 0 42 0 0 0 0 10 3 2 3 2 3 2 3 2 3 2 3 2 3 2 3 2 3 2 3 2 3 2 3 2 3 11 42 42 42 0 0 42 42 0 42 42 0 0 
0 0 0 0 0 0 0 0 0 0 0 42 42 0 42 42 42 42 0 42 42 42 0 42 42 42 42 42 0 0 0 0 0 42 0 0 42 0 0 0 42 42 42 0 42 0 0 0 0 0 
0 0 0 0 0 0 42 42 42 42 42 42 42 0 0 0 42 0 0 0 0 0 0 42 0 42 42 0 42 42 42 0 0 42 42 42 0 42 42 42 42 42 0 42 0 0 0 0 0 0 
0 0 0 0 0 0 0 42 42 0 42 42 0 0 0 0 0 0 0 42 0 0 0 0 0 0 42 42 42 0 0 0 0 42 0 0 0 0 0 0 0 0 0 0 0 0 0 0 0 0 
0 0 0 0 0 0 42 0 0 42 42 0 0 0 0 0 42 42 42 42 0 0 42 0 0 0 42 42 42 0 0 0 42 42 42 42 0 0 0 0 0 0 0 0 0 0 0 42 0 0 
0 0 0 0 0 0 0 0 0 0 0 0 0 0 0 0 0 0 42 0 0 0 0 0 0 0 0 0 0 0 0 0 0 0 0 0 0 0 0 42 42 0 0 0 0 0 0 0 0 0 
0 0 0 0 0 0 0 0 0 0 0 0 0 0 0 0 0 0 0 0 0 0 0 0 0 0 0 0 0 0 0 0 0 0 0 0 0 0 0 0 0 42 0 0 0 0 0 0 0 0 
0 0 0 0 0 0 0 0 0 0 0 0 0 0 0 0 0 0 0 0 0 0 0 0 0 0 0 0 0 0 0 0 0 0 0 0 0 0 0 0 0 0 0 0 0 0 0 0 0 0 
