0 0 0 0 0 0 0 0 0 0 0 0 0 0 0 0 0 0 0 0 0 0 0 0 0 0 0 0 0 0 0 0 0 0 0 0 0 0 0 0 0 0 0 0 0 0 0 0 0 0 
0 0 0 0 0 0 0 0 0 0 0 0 0 0 0 0 0 0 0 0 0 0 0 0 0 0 0 0 0 0 0 0 0 0 0 0 0 0 0 0 0 0 0 0 0 0 0 0 0 0 
0 0 0 0 0 0 0 0 0 0 0 0 0 0 0 0 0 0 0 0 0 0 0 8 16 16 16 16 16 16 9 0 0 0 0 0 0 0 0 0 0 0 0 0 0 0 0 0 0 0 
0 0 0 0 0 0 0 0 0 0 0 0 0 0 0 0 0 0 0 0 0 0 0 12 49 48 61 28 49 48 13 0 0 0 0 0 0 0 0 0 0 0 0 0 0 0 0 0 0 0 
0 0 0 0 0 0 0 0 0 0 0 0 0 0 0 0 0 0 0 0 0 0 0 12 17 24 20 20 23 18 13 0 0 0 0 0 0 0 0 0 0 0 0 0 0 0 0 0 0 0 
0 0 0 0 0 0 0 0 0 0 0 0 0 0 0 0 0 0 0 0 0 0 0 12 17 25 25 25 25 18 13 0 0 0 0 0 0 0 0 0 0 0 0 0 0 0 0 0 0 0 
0 0 0 0 0 0 0 0 8 16 16 16 16 16 16 16 16 16 16 16 16 16 16 15 46 19 21 22 19 47 14 16 16 16 16 16 16 16 16 16 16 16 16 9 0 0 0 0 0 0 
0 0 0 0 0 0 0 0 12 27 27 27 27 27 27 27 27 27 27 27 27 27 27 27 30 1 17 18 1 1 27 27 27 27 27 27 27 27 27 27 27 27 27 13 0 0 0 0 0 0 
0 0 0 0 0 0 0 0 12 27 59 59 59 59 59 59 59 59 59 59 59 59 59 59 59 59 1 1 59 59 59 59 59 59 59 59 59 59 59 59 59 59 27 13 0 0 0 0 0 0 
0 0 0 0 0 0 0 0 12 27 59 1 1 1 38 38 38 38 38 1 1 1 38 1 1 59 1 1 59 38 1 38 1 1 38 1 38 38 1 1 36 59 27 13 0 0 0 0 0 0 
0 0 0 0 0 0 0 0 12 27 59 1 59 59 59 59 59 59 59 59 59 59 59 35 30 1 1 1 59 1 59 1 59 59 59 59 59 59 59 59 1 59 27 13 0 0 0 0 0 0 
0 0 0 0 0 0 0 0 12 27 59 1 38 38 38 1 1 1 35 32 1 1 59 59 59 59 59 59 59 1 59 38 59 1 59 38 59 1 1 1 1 59 27 13 0 0 0 0 0 0 
0 0 0 0 0 0 0 0 12 27 59 59 59 59 59 59 59 59 1 59 1 38 59 1 1 1 59 1 1 38 59 1 59 35 59 38 1 1 59 59 59 59 27 13 0 0 0 0 0 0 
0 0 0 0 0 0 0 0 12 27 59 1 1 1 1 1 1 59 59 59 1 59 59 59 59 1 59 38 59 1 1 1 59 35 59 38 59 1 1 1 37 59 27 13 0 0 0 0 0 0 
0 0 0 0 0 0 0 0 12 27 59 59 59 59 59 59 38 1 1 1 1 59 35 37 59 1 59 1 59 59 59 59 59 1 59 1 59 59 59 59 1 59 27 13 0 0 0 0 0 0 
0 0 0 0 0 0 0 0 12 27 59 1 35 37 59 59 1 59 59 59 1 59 59 1 59 38 59 38 59 35 1 1 59 1 59 1 1 1 1 59 1 59 27 13 0 0 0 0 0 0 
0 0 0 0 0 0 0 0 12 27 59 1 59 59 59 59 59 59 1 59 1 1 1 1 59 1 59 1 59 1 59 38 1 1 38 38 1 59 38 59 38 59 27 13 0 0 0 0 0 0 
0 0 0 0 0 0 0 0 12 27 59 1 59 1 1 59 1 59 1 59 1 59 59 59 59 1 59 1 59 38 59 59 59 59 59 59 59 59 1 59 1 59 27 13 0 0 0 0 0 0 
0 0 0 0 0 0 0 0 12 27 59 1 59 1 1 38 1 59 38 59 1 38 30 1 1 38 59 38 59 1 1 38 1 38 38 1 38 1 38 59 38 59 27 13 0 0 0 0 0 0 
0 0 0 0 0 0 0 0 12 27 59 38 59 1 59 59 59 59 38 59 59 59 59 38 59 59 59 1 59 38 59 59 59 59 59 59 59 59 59 59 1 59 27 13 0 0 0 0 0 0 
0 0 0 0 0 0 0 0 12 27 59 1 59 1 1 1 38 1 1 59 1 1 59 1 59 1 1 38 59 38 1 38 1 1 1 38 38 1 1 38 38 59 27 13 0 0 0 0 0 0 
0 0 0 0 0 0 0 0 12 27 59 38 59 1 59 1 59 59 59 59 1 59 59 38 59 1 59 1 59 1 59 59 59 59 59 59 59 59 59 59 1 59 27 13 0 0 0 0 0 0 
0 0 0 0 0 0 0 0 12 27 59 1 59 1 59 38 1 1 59 1 1 59 1 1 59 38 59 38 59 38 59 1 1 1 1 1 1 1 1 59 38 59 27 13 0 0 0 0 0 0 
0 0 0 0 0 0 0 0 12 27 59 38 1 38 59 59 59 59 59 1 59 59 59 1 59 38 59 1 59 38 59 38 59 59 1 59 59 59 38 59 1 59 27 13 0 0 0 0 0 0 
0 0 0 0 0 0 0 0 12 27 59 1 59 1 1 1 38 1 59 1 59 38 1 38 59 38 59 1 59 1 59 38 59 1 1 38 38 59 1 59 38 59 27 13 0 0 0 0 0 0 
0 0 0 0 0 0 0 0 12 27 59 1 59 38 59 59 59 1 59 1 59 1 59 59 59 1 59 38 1 1 59 1 59 1 59 59 59 59 1 59 38 59 27 13 0 0 0 0 0 0 
0 0 0 0 0 0 0 0 12 27 59 38 59 1 59 1 1 1 1 1 59 1 59 1 59 1 59 38 59 59 59 38 59 1 59 1 1 1 38 1 1 59 27 13 0 0 0 0 0 0 
0 0 0 0 0 0 0 0 12 27 59 1 59 29 59 1 59 59 59 59 59 38 59 1 1 38 1 1 1 1 1 1 59 38 59 38 59 1 38 59 1 59 27 13 0 0 0 0 0 0 
0 0 0 0 0 0 0 0 12 27 59 1 59 31 59 1 1 1 1 1 38 1 59 59 59 59 1 38 59 59 59 59 59 1 59 38 59 59 59 59 59 59 27 13 0 0 0 0 0 0 
0 0 0 0 0 0 0 0 12 27 59 1 59 1 59 59 59 59 59 59 59 59 59 1 1 1 38 1 1 1 1 1 1 38 59 1 1 1 1 1 1 59 27 13 0 0 0 0 0 0 
0 0 0 0 0 0 0 0 12 27 59 1 59 38 1 1 1 38 38 38 1 1 38 1 59 59 1 1 59 59 59 59 59 59 59 59 59 59 59 59 38 59 27 13 0 0 0 0 0 0 
0 0 0 0 0 0 0 0 12 27 59 38 59 34 59 59 59 59 59 59 59 59 59 1 1 1 1 38 1 1 1 38 38 1 38 1 1 38 1 59 1 59 27 13 0 0 0 0 0 0 
0 0 0 0 0 0 0 0 12 27 59 1 59 59 59 1 38 38 1 38 1 1 59 59 59 59 1 1 59 59 59 59 59 59 59 59 59 59 59 59 1 59 27 13 0 0 0 0 0 0 
0 0 0 0 0 0 0 0 12 27 59 38 1 1 1 38 38 1 1 1 38 1 1 1 1 1 38 38 1 1 1 1 1 38 38 38 38 38 38 1 38 59 27 13 0 0 0 0 0 0 
0 0 0 0 0 0 0 0 12 27 59 59 59 59 59 59 59 59 59 59 59 59 59 59 59 59 1 38 59 59 59 59 59 59 59 59 59 59 59 59 59 59 27 13 0 0 0 0 0 0 
0 0 0 0 0 0 0 0 12 27 1 34 1 1 1 29 35 1 1 1 1 1 1 1 29 1 38 1 1 1 1 1 1 34 1 1 1 1 29 1 29 1 27 13 0 0 0 0 0 0 
0 0 0 0 0 0 0 0 12 27 27 27 27 27 27 27 27 27 27 27 27 27 27 27 1 1 17 18 1 27 27 27 27 27 27 27 27 27 27 27 27 27 27 13 0 0 0 0 0 0 
0 0 0 0 0 0 0 0 10 3 2 3 2 3 2 3 2 3 2 3 2 3 2 5 49 20 23 24 20 48 4 2 3 3 2 3 2 3 2 2 2 2 3 11 0 0 0 0 0 0 
0 0 0 0 0 0 0 0 0 0 0 0 0 0 0 0 0 0 0 0 0 0 0 12 17 22 19 19 21 18 13 0 0 0 0 0 0 0 0 0 0 0 0 0 0 0 0 0 0 0 
0 0 0 0 0 0 0 0 0 0 0 0 0 0 0 0 0 0 0 0 0 0 0 12 46 47 35 61 46 47 13 0 0 0 0 0 0 0 0 0 0 0 0 0 0 0 0 0 0 0 
0 0 0 0 0 0 0 0 0 0 0 0 0 0 0 0 0 0 0 0 0 0 0 10 2 3 2 3 2 3 11 0 0 0 0 0 0 0 0 0 0 0 0 0 0 0 0 0 0 0 
0 0 0 0 0 0 0 0 0 0 0 0 0 0 0 0 0 0 0 0 0 0 0 0 0 0 0 0 0 0 0 0 0 0 0 0 0 0 0 0 0 0 0 0 0 0 0 0 0 0 
0 0 0 0 0 0 0 0 0 0 0 0 0 0 0 0 0 0 0 0 0 0 0 0 0 0 0 0 0 0 0 0 0 0 0 0 0 0 0 0 0 0 0 0 0 0 0 0 0 0 
0 0 0 0 0 0 0 0 0 0 0 0 0 0 0 0 0 0 0 0 0 0 0 0 0 0 0 0 0 0 0 0 0 0 0 0 0 0 0 0 0 0 0 0 0 0 0 0 0 0 
0 0 0 0 0 0 0 0 0 0 0 0 0 0 0 0 0 0 0 0 0 0 0 0 0 0 0 0 0 0 0 0 0 0 0 0 0 0 0 0 0 0 0 0 0 0 0 0 0 0 
0 0 0 0 0 0 0 0 0 0 0 0 0 0 0 0 0 0 0 0 0 0 0 0 0 0 0 0 0 0 0 0 0 0 0 0 0 0 0 0 0 0 0 0 0 0 0 0 0 0 
0 0 0 0 0 0 0 0 0 0 0 0 0 0 0 0 0 0 0 0 0 0 0 0 0 0 0 0 0 0 0 0 0 0 0 0 0 0 0 0 0 0 0 0 0 0 0 0 0 0 
0 0 0 0 0 0 0 0 0 0 0 0 0 0 0 0 0 0 0 0 0 0 0 0 0 0 0 0 0 0 0 0 0 0 0 0 0 0 0 0 0 0 0 0 0 0 0 0 0 0 
0 0 0 0 0 0 0 0 0 0 0 0 0 0 0 0 0 0 0 0 0 0 0 0 0 0 0 0 0 0 0 0 0 0 0 0 0 0 0 0 0 0 0 0 0 0 0 0 0 0 
0 0 0 0 0 0 0 0 0 0 0 0 0 0 0 0 0 0 0 0 0 0 0 0 0 0 0 0 0 0 0 0 0 0 0 0 0 0 0 0 0 0 0 0 0 0 0 0 0 0 
