0 0 0 0 0 0 0 0 0 0 0 0 0 0 0 0 0 0 0 0 0 0 0 0 0 0 0 0 0 0 0 0 0 0 0 0 0 0 0 0 0 0 0 0 0 0 0 0 0 0 
0 0 0 0 0 0 0 0 0 0 0 0 0 0 0 0 0 0 0 0 0 0 0 0 0 0 0 0 0 0 0 0 0 0 0 0 0 0 0 0 0 0 0 0 0 0 0 0 0 0 
0 0 0 0 0 0 0 0 0 0 0 0 0 0 0 0 0 0 0 0 0 0 0 0 0 0 0 0 0 0 0 0 0 0 0 0 0 0 0 0 0 0 0 0 0 0 0 0 0 0 
0 0 0 0 0 0 0 0 0 0 0 0 0 0 0 0 0 0 0 0 0 0 0 0 0 0 0 0 0 0 0 0 0 0 0 0 0 0 0 0 0 0 0 0 0 0 0 0 0 0 
0 0 0 0 0 0 0 0 0 0 0 0 0 0 0 0 0 0 0 0 0 0 0 0 0 0 0 0 0 0 0 0 0 0 0 0 8 16 16 16 16 16 9 0 0 0 0 0 0 0 
0 0 0 0 0 0 0 0 0 0 0 0 0 0 0 0 8 16 16 16 16 16 16 16 9 0 0 0 0 0 0 0 0 0 0 8 15 27 27 27 27 27 14 9 0 0 0 0 0 0 
0 0 0 0 0 0 0 0 0 0 0 0 0 0 0 8 15 27 27 26 26 31 27 27 14 16 16 16 16 16 16 16 16 16 16 15 34 49 20 20 20 48 27 13 0 0 0 0 0 0 
0 0 0 0 0 0 0 0 0 0 0 0 0 0 0 12 27 49 20 48 1 1 1 1 1 1 38 38 38 1 38 38 38 1 1 1 1 17 25 25 25 18 60 13 0 0 0 0 0 0 
0 0 0 0 0 0 0 0 0 0 0 0 0 0 0 12 27 46 19 47 1 1 1 1 27 4 3 2 3 2 3 2 3 2 3 5 1 46 19 19 19 47 27 13 0 0 0 0 0 0 
0 0 0 0 0 0 0 0 0 0 0 0 0 0 0 10 5 27 27 1 1 1 1 27 4 11 0 0 0 0 0 0 0 0 0 10 5 27 27 27 27 27 4 0 0 0 0 0 0 0 
0 0 0 0 0 0 0 0 0 8 16 9 0 0 0 0 10 3 2 5 1 1 31 4 11 0 0 0 0 0 0 0 0 0 0 0 10 3 2 3 2 3 11 0 0 0 0 0 0 0 
0 0 0 0 0 0 0 0 8 15 27 14 9 0 0 0 0 0 0 10 5 38 4 11 0 0 8 9 0 8 16 9 0 8 9 0 0 0 0 0 0 0 0 0 0 0 0 0 0 0 
0 0 0 0 0 0 0 0 12 27 27 27 13 0 0 0 0 0 0 0 12 38 13 0 0 0 10 11 0 10 3 11 0 10 11 0 0 0 0 0 0 0 0 0 0 0 0 0 0 0 
0 0 0 0 0 0 0 0 12 27 27 27 13 0 0 0 0 0 0 0 12 38 13 0 0 0 0 0 0 0 0 0 0 0 0 0 0 0 0 0 0 0 0 0 0 0 0 0 0 0 
0 0 0 0 0 0 0 0 10 5 27 4 11 0 0 0 0 0 8 16 15 1 14 16 16 9 0 0 0 0 0 0 0 0 0 8 16 16 16 9 0 0 0 0 0 0 0 0 0 0 
0 0 0 0 0 8 9 0 0 10 3 11 0 0 0 0 0 8 15 32 1 1 1 32 27 14 16 16 16 16 16 16 16 16 16 15 27 27 27 14 9 0 0 0 0 8 16 9 0 0 
0 0 0 0 0 10 11 0 0 0 8 9 0 0 0 0 0 12 27 1 49 20 48 1 1 1 1 1 38 38 38 1 1 1 1 1 1 1 1 32 13 0 0 0 8 15 27 14 9 0 
0 0 0 0 0 0 0 0 0 0 12 13 0 0 0 0 0 12 27 32 46 19 47 1 27 4 3 2 3 2 3 2 3 2 5 28 1 1 1 32 13 0 0 0 12 27 27 27 13 0 
0 0 0 0 8 16 9 0 0 0 12 13 0 0 0 0 0 10 5 27 27 27 27 27 4 11 0 0 0 0 0 0 0 0 10 5 28 1 1 4 11 0 0 0 10 5 27 4 11 0 
0 0 0 0 12 27 13 0 0 0 10 11 0 0 0 0 0 0 10 3 2 3 2 3 11 0 0 0 0 0 0 0 0 0 0 10 5 1 4 11 0 0 0 0 0 10 3 11 0 0 
0 0 0 0 10 3 11 0 0 0 0 0 0 0 0 0 0 0 0 0 0 0 0 0 0 0 0 0 0 0 0 0 0 0 0 0 12 1 13 0 0 0 0 0 0 0 0 0 0 0 
0 0 0 0 0 0 0 0 0 0 0 0 0 0 0 0 0 0 0 0 0 0 0 0 0 0 8 16 16 16 16 16 16 16 16 16 15 38 13 0 0 0 0 0 0 0 0 0 0 0 
0 0 0 0 0 0 0 0 0 0 0 0 8 16 16 16 16 16 9 0 0 0 0 0 0 8 15 26 26 33 33 33 1 1 1 1 38 38 13 0 0 0 8 16 9 0 0 0 0 0 
0 0 0 0 0 8 9 0 0 0 0 8 15 27 27 27 27 27 14 16 16 16 16 16 16 15 1 1 1 1 1 1 1 4 3 3 2 2 11 0 0 0 12 4 11 0 0 0 0 0 
0 0 0 0 0 10 11 8 9 0 0 12 27 1 1 1 1 1 1 1 1 38 38 38 1 1 1 1 1 1 1 1 26 13 0 0 0 0 0 0 0 0 12 13 0 0 0 0 0 0 
0 0 0 8 16 9 0 10 11 0 0 12 27 49 20 20 48 1 1 4 3 2 3 2 3 5 27 27 33 1 1 33 26 13 0 0 0 0 0 0 0 0 12 13 0 0 0 0 0 0 
0 0 8 15 27 14 16 16 16 9 0 12 27 46 21 22 47 1 35 13 0 0 0 0 0 10 3 5 27 27 27 27 4 11 0 0 0 8 16 9 0 0 10 11 0 0 0 0 0 0 
0 0 12 27 27 27 27 27 27 13 0 12 27 27 46 47 35 27 27 13 0 0 0 0 0 0 0 10 2 3 2 3 11 0 0 0 0 12 27 13 0 0 0 0 0 0 0 0 0 0 
0 0 10 5 27 4 3 2 3 11 0 10 2 5 27 1 27 4 3 11 0 0 0 0 0 0 0 0 0 0 0 0 0 0 0 0 0 10 3 11 0 0 0 0 0 0 0 0 0 0 
0 0 0 10 3 11 0 0 0 0 0 0 0 10 5 1 4 11 0 0 0 0 0 0 0 0 0 0 0 0 0 0 0 0 8 9 0 0 0 0 0 0 8 9 0 0 0 0 0 0 
0 0 0 0 0 0 0 8 9 0 0 0 0 0 12 39 14 16 16 16 16 16 16 16 16 16 16 16 16 16 16 16 9 0 12 13 0 0 0 0 0 0 10 11 0 0 0 0 0 0 
0 0 0 0 0 8 9 10 11 0 0 0 0 0 12 38 1 1 1 38 1 38 38 38 1 1 1 1 1 38 38 38 13 0 10 11 0 0 0 0 0 0 0 0 0 0 0 0 0 0 
0 0 0 0 0 10 11 0 0 0 0 0 0 0 12 1 4 3 2 3 2 3 2 3 2 3 2 3 2 2 5 38 13 0 0 0 0 0 0 0 8 9 0 0 0 0 0 0 0 0 
0 0 0 0 0 0 0 0 0 0 0 0 0 0 12 38 13 0 0 0 0 0 0 0 0 0 0 0 0 0 12 1 13 0 0 0 0 0 0 0 10 11 0 0 0 0 0 0 0 0 
0 0 0 0 0 0 0 0 0 0 0 0 8 16 15 1 14 9 0 0 0 0 0 0 0 0 0 0 0 0 12 1 13 0 0 0 0 0 0 0 0 0 8 9 0 0 0 0 0 0 
0 0 0 0 0 0 0 0 0 0 0 8 15 35 1 1 37 14 9 0 0 0 0 8 9 0 0 0 0 8 15 1 14 9 0 0 0 0 0 0 0 0 10 11 0 0 0 0 0 0 
0 0 0 0 0 0 0 0 0 0 0 12 35 49 20 20 48 35 14 9 0 0 0 10 11 0 0 0 8 15 35 1 35 14 16 9 0 0 0 0 0 0 0 0 0 0 0 0 0 0 
0 0 0 0 0 0 0 0 0 0 0 12 27 46 21 25 24 48 27 13 0 0 0 0 0 0 0 0 12 27 35 1 1 27 27 13 0 0 0 0 0 0 0 0 0 0 0 0 0 0 
0 0 0 0 0 0 0 0 0 0 0 10 5 27 46 19 19 47 4 11 0 0 0 0 0 0 0 0 12 27 49 20 48 1 1 14 9 0 0 0 0 0 0 0 0 0 0 0 0 0 
0 0 0 0 0 0 0 0 0 0 0 0 12 27 27 27 37 60 13 0 0 0 0 0 0 0 0 0 12 27 46 21 24 48 1 1 13 0 0 0 0 0 0 0 0 0 0 0 0 0 
0 0 0 0 0 0 0 0 0 0 0 0 10 3 2 2 3 2 11 0 0 0 0 0 0 0 0 0 10 5 1 46 19 47 27 4 11 0 0 0 0 0 0 0 0 0 0 0 0 0 
0 0 0 0 0 0 0 0 0 0 0 0 0 0 0 0 0 0 0 0 0 0 0 0 0 0 0 0 0 10 5 35 35 35 4 11 0 0 0 0 0 0 0 0 0 0 0 0 0 0 
0 0 0 0 0 0 0 0 0 0 0 0 0 0 0 0 0 0 0 0 0 0 0 0 0 0 0 0 0 0 10 3 3 3 11 0 0 0 0 0 0 0 0 0 0 0 0 0 0 0 
0 0 0 0 0 0 0 0 0 0 0 0 0 0 0 0 0 0 0 0 0 0 0 0 0 0 0 0 0 0 0 0 0 0 0 0 0 0 0 0 0 0 0 0 0 0 0 0 0 0 
0 0 0 0 0 0 0 0 0 0 0 0 0 0 0 0 0 0 0 0 0 0 0 0 0 0 0 0 0 0 0 0 0 0 0 0 0 0 0 0 0 0 0 0 0 0 0 0 0 0 
0 0 0 0 0 0 0 0 0 0 0 0 0 0 0 0 0 0 0 0 0 0 0 0 0 0 0 0 0 0 0 0 0 0 0 0 0 0 0 0 0 0 0 0 0 0 0 0 0 0 
0 0 0 0 0 0 0 0 0 0 0 0 0 0 0 0 0 0 0 0 0 0 0 0 0 0 0 0 0 0 0 0 0 0 0 0 0 0 0 0 0 0 0 0 0 0 0 0 0 0 
0 0 0 0 0 0 0 0 0 0 0 0 0 0 0 0 0 0 0 0 0 0 0 0 0 0 0 0 0 0 0 0 0 0 0 0 0 0 0 0 0 0 0 0 0 0 0 0 0 0 
0 0 0 0 0 0 0 0 0 0 0 0 0 0 0 0 0 0 0 0 0 0 0 0 0 0 0 0 0 0 0 0 0 0 0 0 0 0 0 0 0 0 0 0 0 0 0 0 0 0 
0 0 0 0 0 0 0 0 0 0 0 0 0 0 0 0 0 0 0 0 0 0 0 0 0 0 0 0 0 0 0 0 0 0 0 0 0 0 0 0 0 0 0 0 0 0 0 0 0 0 
